100 100
1111111111111111111111111111111111111111111111111111111111111111111111111111111111111111111111111111
1223322332233223322332233223322332233223322222233333333333332223333333333222333322332332323333322221
1213121313121312131312131213131213121313121312131312131213131213121313121312131312131213131213121311
1223322332233223322332233223322332233223322222233333333333332223333333333222333322332332323333322221
1010101010101012101010101010101010101210101010101313131010101010131010101010131013101010101010101011
1223322332233223322332233223322332233223322222233333333333332223333333333222333322332332323333322221
1213121313121312131312131213131213121313121312131312131213131213121313121312131312131213131213121311
1223322332233223322332233223322332233223322222233333333333332223333333333222333322332332323333322221
1010101010101012101010101010101010101210101010101313131010101010131010101010131013101010101010101011
1223322332233223322332233223322332233223322222233333333333332223333333333222333322332332323333322221
1213121313121312131312131213131213121313121312131312131213131213121313121312131312131213131213121311
1223322332233223322332233223322332233223322222233333333333332223333333333222333322332332323333322221
1213121313121312131312131213131213121313121312131312131213131213121313121312131312131213131213121311
1223322332233223322332233223322332233223322222233333333333332223333333333222333322332332323333322221
1010101010101012101010101010101010101210101010101313131010101010131010101010131013101010101010101011
1223322332233223322332233223322332233223322222233333333333332223333333333222333322332332323333322221
1213121313121312131312131213131213121313121312131312131213131213121313121312131312131213131213121311
1223322332233223322332233223322332233223322222233333333333332223333333333222333322332332323333322221
1010101010101012101010101010101010101210101010101313131010101010131010101010131013101010101010101011
1223322332233223322332233223322332233223322222233333333333332223333333333222333322332332323333322221
1213121313121312131312131213131213121313121312131312131213131213121313121312131312131213131213121311
1223322332233223322332233223322332233223322222233333333333332223333333333222333322332332323333322221
1213121313121312131312131213131213121313121312131312131213131213121313121312131312131213131213121311
1223322332233223322332233223322332233223322222233333333333332223333333333222333322332332323333322221
1010101010101012101010101010101010101210101010101313131010101010131010101010131013101010101010101011
1223322332233223322332233223322332233223322222233333333333332223333333333222333322332332323333322221
1213121313121312131312131213131213121313121312131312131213131213121313121312131312131213131213121311
1223322332233223322332233223322332233223322222233333333333332223333333333222333322332332323333322221
1010101010101012101010101010101010101210101010101313131010101010131010101010131013101010101010101011
1223322332233223322332233223322332233223322222233333333333332223333333333222333322332332323333322221
1213121313121312131312131213131213121313121312131312131213131213121313121312131312131213131213121311
1223322332233223322332233223322332233223322222233333333333332223333333333222333322332332323333322221
1213121313121312131312131213131213121313121312131312131213131213121313121312131312131213131213121311
1223322332233223322332233223322332233223322222233333333333332223333333333222333322332332323333322221
1010101010101012101010101010101010101210101010101313131010101010131010101010131013101010101010101011
1223322332233223322332233223322332233223322222233333333333332223333333333222333322332332323333322221
1213121313121312131312131213131213121313121312131312131213131213121313121312131312131213131213121311
1223322332233223322332233223322332233223322222233333333333332223333333333222333322332332323333322221
1010101010101012101010101010101010101210101010101313131010101010131010101010131013101010101010101011
1223322332233223322332233223322332233223322222233333333333332223333333333222333322332332323333322221
1213121313121312131312131213131213121313121312131312131213131213121313121312131312131213131213121311
1223322332233223322332233223322332233223322222233333333333332223333333333222333322332332323333322221
1213121313121312131312131213131213121313121312131312131213131213121313121312131312131213131213121311
1223322332233223322332233223322332233223322222233333333333332223333333333222333322332332323333322221
1010101010101012101010101010101010101210101010101313131010101010131010101010131013101010101010101011
1223322332233223322332233223322332233223322222233333333333332223333333333222333322332332323333322221
1213121313121312131312131213131213121313121312131312131213131213121313121312131312131213131213121311
1223322332233223322332233223322332233223322222233333333333332223333333333222333322332332323333322221
1010101010101012101010101010101010101210101010101313131010101010131010101010131013101010101010101011
1223322332233223322332233223322332233223322222233333333333332223333333333222333322332332323333322221
1213121313121312131312131213131213121313121312131312131213131213121313121312131312131213131213121311
1223322332233223322332233223322332233223322222233333333333332223333333333222333322332332323333322221
1213121313121312131312131213131213121313121312131312131213131213121313121312131312131213131213121311
1223322332233223322332233223322332233223322222233333333333332223333333333222333322332332323333322221
1010101010101012101010101010101010101210101010101313131010101010131010101010131013101010101010101011
1223322332233223322332233223322332233223322222233333333333332223333333333222333322332332323333322221
1213121313121312131312131213131213121313121312131312131213131213121313121312131312131213131213121311
1223322332233223322332233223322332233223322222233333333333332223333333333222333322332332323333322221
1010101010101012101010101010101010101210101010101313131010101010131010101010131013101010101010101011
1223322332233223322332233223322332233223322222233333333333332223333333333222333322332332323333322221
1213121313121312131312131213131213121313121312131312131213131213121313121312131312131213131213121311
1223322332233223322332233223322332233223322222233333333333332223333333333222333322332332323333322221
1213121313121312131312131213131213121313121312131312131213131213121313121312131312131213131213121311
1223322332233223322332233223322332233223322222233333333333332223333333333222333322332332323333322221
1010101010101012101010101010101010101210101010101313131010101010131010101010131013101010101010101011
1223322332233223322332233223322332233223322222233333333333332223333333333222333322332332323333322221
1213121313121312131312131213131213121313121312131312131213131213121313121312131312131213131213121311
1223322332233223322332233223322332233223322222233333333333332223333333333222333322332332323333322221
1010101010101012101010101010101010101210101010101313131010101010131010101010131013101010101010101011
1223322332233223322332233223322332233223322222233333333333332223333333333222333322332332323333322221
1213121313121312131312131213131213121313121312131312131213131213121313121312131312131213131213121311
1223322332233223322332233223322332233223322222233333333333332223333333333222333322332332323333322221
1213121313121312131312131213131213121313121312131312131213131213121313121312131312131213131213121311
1223322332233223322332233223322332233223322222233333333333332223333333333222333322332332323333322221
1010101010101012101010101010101010101210101010101313131010101010131010101010131013101010101010101011
1223322332233223322332233223322332233223322222233333333333332223333333333222333322332332323333322221
1213121313121312131312131213131213121313121312131312131213131213121313121312131312131213131213121311
1223322332233223322332233223322332233223322222233333333333332223333333333222333322332332323333322221
1010101010101012101010101010101010101210101010101313131010101010131010101010131013101010101010101011
1223322332233223322332233223322332233223322222233333333333332223333333333222333322332332323333322221
1213121313121312131312131213131213121313121312131312131213131213121313121312131312131213131213121311
1223322332233223322332233223322332233223322222233333333333332223333333333222333322332332323333322221
1213121313121312131312131213131213121313121312131312131213131213121313121312131312131213131213121311
1223322332233223322332233223322332233223322222233333333333332223333333333222333322332332323333322221
1010101010101012101010101010101010101210101010101313131010101010131010101010131013101010101010101011
1223322332233223322332233223322332233223322222233333333333332223333333333222333322332332323333322221
1213121313121312131312131213131213121313121312131312131213131213121313121312131312131213131213121311
1223322332233223322332233223322332233223322222233333333333332223333333333222333322332332323333322221
1010101010101012101010101010101010101210101010101313131010101010131010101010131013101010101010101011
1223322332233223322332233223322332233223322222233333333333332223333333333222333322332332323333322221
1213121313121312131312131213131213121313121312131312131213131213121313121312131312131213131213121311
1223322332233223322332233223322332233223322222233333333333332223333333333222333322332332323333322221
1213121313121312131312131213131213121313121312131312131213131213121313121312131312131213131213121311
1223322332233223322332233223322332233223322222233333333333332223333333333222333322332332323333322221
1010101010101012101010101010101010101210101010101313131010101010131010101010131013101010101010101011
1223322332233223322332233223322332233223322222233333333333332223333333333222333322332332323333322221
1213121313121312131312131213131213121313121312131312131213131213121313121312131312131213131213121311
1223322332233223322332233223322332233223322222233333333333332223333333333222333322332332323333322221
1010101010101012101010101010101010101210101010101313131010101010131010101010131013101010101010101011
1111111111111111111111111111111111111111111111111111111111111111111111111111111111111111111111111111
