21 21
111111111111111111111
102323232121323230001
103131313121212121311
123232323131323323201
100000110000011111331
100001210010132323121
100012310000132321321
100103310000032310321
101202003232320103231
111111111110001232301
103323310000010032321
130323310000102311111
103303210000100323001
100220111320111111101
102323232323200323201
101012313102121321211
112321133211302113231
113231123311230113231
131313212100131321311
123232323232032323321
111111111111111111111