20 20
11111111111111111111
13333333333333333331
12121212121212121211
12222222222222222221
11011111100111111011
10010000000000001021
11010111100111101011
10010130000003101001
10010130333303101001
10110000333300001101
10110000333300001101
10120130333303102101
10120130000003102101
10120111100111102101
10120000000000002101
10111111000011111101
12222222222222222221
12121212121212121211
13333333333333333331
11111111111111111111