20 20
11111111111111111111
12222222222222222221
12121212121212121211
12222222222222222221
11011111100111111011
10010000000000001021
11010111100111101011
10010120000002101001
10010120222202101001
10110000222200001101
10110000222200001101
10120120222202102101
10120120000002102101
10120111100111102101
10120000000000002101
10111111000011111101
12222222222222222221
12121212121212121211
12222222222222222221
11111111111111111111