10 10
1111111111
1232222331
1011111121
1302232131
1311113131
1012213131
1212222131
1211111121
1232322231
1111111111